const savedDeserTileName = {
  0: "erase",
  1: "dirt",
  2: "platform",
  3: "ladder",
  4: "ladderPlatform",
}

const tileData = `
  00000000000000000
  00001111111111000
  00011100001111100
  00011100001111111
  00000000001111111
  11111422221110001
  11110300000000001
  11100422224222421
  13000300003000301
  14122111111122421
  13000011100000301
  13000000000000301
  14224224224222401
  13003003003000301
  11242111111111111
  11030011000000111
  10030000000000001
  10030004222400001
  11111111101112411
  11110000000000301
  11110000000000301
  11110424000000301
  11111111111111111
`

const actorData = `
  hero 2 4
  gem 6 20
`
