const tileData = `
00000000000000000
00001111111111000
00011100001111100
00011100001111111
00000000001111111
11111433331110001
11110200000000001
11100433334333431
12000200002000201
14133111111133431
12000011100000201
12000000000000201
14334334334333401
12002002002000201
11343111111111111
11020011000000111
10020000000000001
10020004333400001
11111111101113411
11110000000000201
11110000000000201
11110434000000201
11111111111111111
`

const actorData = `
heroClimb 0 1
gem 1 0
`
